leaveeu	head=Brexit Leave
no2eu	head=Brexit Leave
betteroffout	head=Brexit Leave
voteleave	head=Brexit Leave
voteout	head=Brexit Leave
notoeu	head=Brexit Leave
britainout	head=Brexit Leave
leadnotleave	head=Brexit Remain
beleave	head=Brexit Leave
EU referendum	head=EU Membership
euref	head=EU Membership
eureferendum	head=EU Membership
eureform	head=EU Membership
brexit	head=EU Membership
votein	head=Brexit Remain
yestoeu	head=Brexit Remain
voteremain	head=Brexit Remain
bremain	head=Brexit Remain
strongerin	head=Brexit Remain
betteroffin	head=Brexit Remain
yes2eu	head=Brexit Remain
ukineu	head=Brexit Remain
transition period
