climate change	head=climate change
climate	modifier=pre
global warming	head=climate change
energy efficiency	head=climate change
energy saving	head=climate change
fracking	head=environment
fossil fuels	head=climate change
fossil fuel	head=climate change
green technology	head=climate change
green technologies	head=climate change
low-carbon	modifier=pre
low-carbon technologies	head=climate change
low-carbon technology	head=climate change
green transport	head=climate change
eco-system	head=environment
eco-systems	head=environment
green cars	head=climate change
climate action	head=climate change
extinction rebellion	head=climate change
climate emergency	head=climate change
climate breakdown	head=climate change
climate crisis	head=climate change
sustainability	head=climate change
zero emissions	head=climate change
low emissions	head=climate change
deforestation	head=environment
land degradation	head=environment
desertification	head=environment
environmental degradation	head=environment
water scarcity	head=environment
biodiversity loss	head=environment
intensive farming	head=environment
ocean acidification	head=environment

