Communities Secretary	head=communities
community groups	head=communities
community empowerment	head=communities
community rights	head=communities
community-led	head=communities
parish council	head=council
town council	head=council
local development	head=development
FGM	head=fgm
forced marriage	head=forced marriage
forced marriages	head=forced marriage
Hindu community	head=Hindu community
Hindus community	head=Hindu community
local council	head=local council
local councils	head=local council
local service transformation	head=local council
local services	head=local council
local opportunities	head=local opportunities
religion	head=religion
religions	head=religion
religious	head=religion
religious affairs	head=religion
Roman Catholic	head=religion
Roman Catholics	head=religion
Catholic	head=religion
Catholics	head=religion
Anglican	head=religion
Anglicans	head=religion
church	head=religion
worship	head=religion
Sikhs	head=sikh
Sikh	head=sikh
social problems	head=social
social problem	head=social
social integration	head=social
social finance	head=social
Sustainable Communities	head=sustainable communities
Sustainable Communities Act	head=sustainable communities
Community	modifier=head
Communities	modifier=head
council	modifier=head
Sikh	modifier=pre
town centres
Jewish community	head=jewish
jewish	head=jewish
jew	head=jewish
judaism	head=jewish
rabbi	head=jewish
Torah	head=jewish
synagogue	head=jewish
lesbians	head=gay community
lesbian	head=gay community
gay and lesbian community	head=gay community
gay community	head=gay community
gay rights	head=gay community
gay and lesbian society	head=gay community
gay	head=gay community
transphobia	head=gay community
transwoman	head=gay community
transman	head=gay community
trans phobia	head=gay community
trans woman	head=gay community
trans man	head=gay community
queer	head=gay community
lgbt	head=gay community
lgbt+	head=gay community
lgbtqia	head=gay community
bisexual	head=gay community
pansexual	head=gay community
bisexuals	head=gay community
pansexuals	head=gay community
non binary	head=gay community
non-binary	head=gay community
nonbinary	head=gay community
trans-woman	head=gay community
trans-man	head=gay community
trans-phobia	head=gay community
transwomen	head=gay community
trans women	head=gay community
trans-women	head=gay community
transmen	head=gay community
trans-men	head=gay community
trans men	head=gay community
lesbians	head=gay community
homosexual	head=gay community
pansexual	head=gay community
gays	head=gay community
Muslim community	head=islam
Muslim	modifier=pre	head=islam
Islam	head=islam
muslims	head=islam
moslems	head=islam
islam	head=islam
muslim	head=islam
moslem	head=islam
islamic	head=islam
allah	head=islam
Allahu akbar	head=islam
azaan 	head=islam
azan	head=islam
burka	head=islam
burqa	head=islam
caliphate	head=islam
dawah	head=islam
eid	head=islam
fatwa	head=islam
friday prayer	head=islam
hadith	head=islam
hajj	head=islam
halal	head=islam
haram	head=islam
hijab	head=islam
imam	head=islam
jamaah	head=islam
jizya	head=islam
jizyah	head=islam
kaaba	head=islam
kafir	head=islam
koran	head=islam
kuffar	head=islam
kuran	head=islam
masjid	head=islam
mosque	head=islam
mullah	head=islam
qur'an	head=islam
quran	head=islam
ramadan	head=islam
sadaqah	head=islam
salaam	head=islam
salat	head=islam
shahada	head=islam
shari'ah	head=islam
sharia	head=islam
shi'a	head=islam
shi'ite	head=islam
sunnah	head=islam
sunni	head=islam
sura	head=islam
surah	head=islam
zakat	head=islam
