consumer	modifier=pre
consumer rights	modifier=pre
consumer rights and issues	head=consumer law
consumer issues	head=consumer law
Consumer Rights Bill	head=consumer law
consumer rights reform programme	head=consumer law
consumer and competition landscape
consumer law	head=consumer law
consumer laws and regulations	head=consumer law
consumer laws	head=consumer law
consumer regulations	head=consumer law
consumer rights' directive	head=consumer law
CRD	head=consumer law
Trading Standards	modifier=pre
Consumer enforcement	head=consumer law
Payment Surcharges Regulations	head=consumer law
Consumer Contracts Regulations	head=consumer law
Citizens Advice	head=Citizens Advice
Citizens Advice Bureau	head=Citizens Advice
Consumer Empowerment Strategy
European Directive on Alternative Dispute Resolution	head=ADR
ADR	head=ADR
Alternative Dispute Resolution	head=ADR
Online Dispute Resolution	head=ODR
ODR	head=ODR
dispute resolution	modifer=head
protected designation of origin	head=PDO
PDO	head=PDO
