covid	head=Covid-19
2019-nCov	head=Covid-19
2019ーnCov	head=Covid-19
covid2019	head=Covid-19
covid 2019	head=Covid-19
covid_2019	head=Covid-19
covid19	head=Covid-19
covid 19	head=Covid-19
covid-19	head=Covid-19
covid_19	head=Covid-19
COVIDー19	head=Covid-19
covidー19uk	head=Covid-19
coviduk	head=Covid-19
covid2019uk	head=Covid-19
covid 2019 uk	head=Covid-19
covid_2019_uk	head=Covid-19
covid19uk	head=Covid-19
covid 19 uk	head=Covid-19
covid-19-uk	head=Covid-19
covid_19_uk	head=Covid-19
covis2019uk	head=Covid-19
covis 2019 uk	head=Covid-19
covis_2019_uk	head=Covid-19
covis19uk	head=Covid-19
covis 19 uk	head=Covid-19
covis-19-uk	head=Covid-19
covis_19_uk	head=Covid-19
corvid2019uk	head=Covid-19
corvid 2019 uk	head=Covid-19
corvid_2019_uk	head=Covid-19
corvid19uk	head=Covid-19
corvid 19 uk	head=Covid-19
corvid-19-uk	head=Covid-19
corvid_19_uk	head=Covid-19
coronavirus	head=Covid-19
corona virus	head=Covid-19
corona19	head=Covid-19
corona2019	head=Covid-19
coronavirus19	head=Covid-19
coronavirus2019	head=Covid-19
timeofcovid	head=Covid-19
timeofcoronavirus	head=Covid-19
survivingcoronavirus	head=Covid-19
survivingcovid	head=Covid-19
fuckcovid	head=Covid-19
fuckcovid19	head=Covid-19
fuckcovid2019	head=Covid-19
fuckcoronavirus	head=Covid-19
coronacrisis	head=Covid-19
coronaoutbreak	head=Covid-19
coronalockdown	head=Covid-19
coronapandemic	head=Covid-19
coronaviruscrisis	head=Covid-19
coronavirusoutbreak	head=Covid-19
coronaviruslockdown	head=Covid-19
coronaviruspandemic	head=Covid-19
covidcrisis	head=Covid-19
covidoutbreak	head=Covid-19
covidlockdown	head=Covid-19
covidpandemic	head=Covid-19
covid19crisis	head=Covid-19
covid19outbreak	head=Covid-19
covid19lockdown	head=Covid-19
covid19pandemic	head=Covid-19
covid2019crisis	head=Covid-19
covid2019outbreak	head=Covid-19
covid2019lockdown	head=Covid-19
covid2019pandemic	head=Covid-19
coronacrisisuk	head=Covid-19
coronaoutbreakuk	head=Covid-19
coronalockdownuk	head=Covid-19
coronapandemicuk	head=Covid-19
coronaviruscrisisuk	head=Covid-19
coronavirusoutbreakuk	head=Covid-19
coronaviruslockdownuk	head=Covid-19
coronaviruspandemicuk	head=Covid-19
covidcrisisuk	head=Covid-19
covidoutbreakuk	head=Covid-19
covidlockdownuk	head=Covid-19
covidpandemicuk	head=Covid-19
covid19crisisuk	head=Covid-19
covid19outbreakuk	head=Covid-19
covid19lockdownuk	head=Covid-19
covid19pandemicuk	head=Covid-19
covid2019crisisuk	head=Covid-19
covid2019outbreakuk	head=Covid-19
covid2019lockdownuk	head=Covid-19
covid2019pandemicuk	head=Covid-19
uklockdown	head=Covid-19
uklockdownnow	head=Covid-19
lockdownuk	head=Covid-19
lockdownnow	head=Covid-19
coronalockdown	head=Covid-19
coronapandemic	head=Covid-19
coronaoutbreak	head=Covid-19
highriskcovid19	head=Covid High Risk
highriskcovid	head=Covid High Risk
panicbuying	head=Covid Panic Buying
panicshopping	head=Covid Panic Buying
dontpanicbuy	head=Covid Panic Buying
toiletpapercrisis	head=Covid Panic Buying
toiletpaperapocalypse	head=Covid Panic Buying
shelter in place	head=Covid Social Distancing
sheltering in place	head=Covid Social Distancing
shelterinplace	head=Covid Social Distancing
shelteringinplace	head=Covid Social Distancing
stayathome	head=Covid Social Distancing
stayathomesavelives	head=Covid Social Distancing
stayathomestaysafe	head=Covid Social Distancing
stayathomeandstaysafe	head=Covid Social Distancing
stayhome	head=Covid Social Distancing
stayhomestaysafe	head=Covid Social Distancing
stayhomesavelives	head=Covid Social Distancing
staysafesavelives	head=Covid Social Distancing
staysafestayhome	head=Covid Social Distancing
safeathome	head=Covid Social Distancing
socialdistancing	head=Covid Social Distancing
physicaldistancing	head=Covid Social Distancing
socialdistancingnow	head=Covid Social Distancing
social_distancing	head=Covid Social Distancing
selfisolation	head=Covid Self-isolation
selfisolating	head=Covid Self-isolation
westayathome	head=Covid Social Distancing
staythefuckhome	head=Covid Social Distancing
flatteningthecurve	head=Covid Social Distancing
flattenthecurve	head=Covid Social Distancing
coronavirusfacts	head=Covid Information
coronafacts	head=Covid Information
coronavirustruth	head=Covid Information
coronatruth	head=Covid Information
coronavirusupdates	head=Covid Information
coronaupdates	head=Covid Information
coronavirusfact	head=Covid Information
coronafact	head=Covid Information
coronavirusupdate	head=Covid Information
coronaupdate	head=Covid Information
coronavirusfakenews	head=Covid Misinformation
coronafakenews	head=Covid Misinformation
covidiots	head=Covid Villains
covididiots	head=Covid Villains
coronavillains	head=Covid Villains
covidheroes	head=Covid Heroes
coronaheroes	head=Covid Heroes
clapforcarers	head=Covid Clap Events
clapforourcarers	head=Covid Clap Events
nhsheroes	head=Covid Heroes
thankyounhs	head=Covid Heroes
nhscovidheroes	head=Covid Heroes
clapforkeyworkers	head=Covid Heroes
newstarterfurlough	head=Covid Employment
newstarterjustice	head=Covid Employment
keyworkers	head=Covid Employment
wholiedpeopledied	head=WHO Blame
chinesevirus19	head=Covid China
chinesevirus	head=Covid China
chinavirus	head=Covid China
wuhanvirus	head=Covid China
chinesewuhanvirus	head=Covid China
chinaliedpeopledied	head=Covid China Blame
chinaliedandpeopledied	head=Covid China Blame
ccpliedpeopledied	head=Covid China Blame
chinamustpay	head=Covid China Blame
makechinapay	head=Covid China Blame
chinesecoronavirus	head=Covid China
chinacoronavirus	head=Covid China
ccpvirus	head=Covid China Blame
wuhancoronavirus	head=Covid China
holdchinaaccountable	head=Covid China Blame
chinesewuhanvirus	head=Covid China
covidhumor	head=Covid Humour
covidjokes	head=Covid Humour
covidhumour	head=Covid Humour
covidmemes	head=Covid Humour
coronahumor	head=Covid Humour
coronajokes	head=Covid Humour
coronajhumour	head=Covid Humour
coronamemes	head=Covid Humour
endlockdown	head=Covid Anti-lockdown
endthelockdown	head=Covid Anti-lockdown
endlockdownuk	head=Covid Anti-lockdown
endthelockdownuk	head=Covid Anti-lockdown
liberateuk	head=Covid Anti-lockdown
liberateengland	head=Covid Anti-lockdown
liberatescotland	head=Covid Anti-lockdown
liberatewales	head=Covid Anti-lockdown
liberatebritain	head=Covid Anti-lockdown
reopenuk	head=Covid Anti-lockdown
reopenengland	head=Covid Anti-lockdown
reopenwales	head=Covid Anti-lockdown
reopenbritain	head=Covid Anti-lockdown
endlockdownnow	head=Covid Anti-lockdown
endthelockdownnow	head=Covid Anti-lockdown
endlockdownnowuk	head=Covid Anti-lockdown
endthelockdownnowuk	head=Covid Anti-lockdown
liberateuknow	head=Covid Anti-lockdown
liberateenglandnow	head=Covid Anti-lockdown
liberatescotlandnow	head=Covid Anti-lockdown
liberatewalesnow	head=Covid Anti-lockdown
liberatebritainnow	head=Covid Anti-lockdown
reopenuknow	head=Covid Anti-lockdown
reopenenglandnow	head=Covid Anti-lockdown
reopenwalesnow	head=Covid Anti-lockdown
reopenbritainnow	head=Covid Anti-lockdown
ppe	head=PPE
ppenow	head=PPE
personal protective equipment	head=PPE
herd immunity	head=Disease Control Strategies
herdimmunity	head=Disease Control Strategies
testtraceisolate	head=Disease Control Strategies
coronavirus test
coronavirus tests
coronavirus testing
covid test
covid tests
covid testing
covid-19 test
covid-19 tests
covid-19 testing
