asylum seeker	head=asylum
asylum seekers	head=asylum
immigration	head=immigration
human trafficking	subtheme=human trafficking
migrant	head=immigration
migrants	head=immigration
refugees	head=refugee
refugee	head=refugee
refugee crisis	head=refugee
political asylum	head=asylum
asylum	head=asylum
illegal immigrants	head=illegal immigrants
border control	head=borders
border controls	head=borders
exit check	head=borders
exit checks	head=borders
people overstaying their visa	subtheme=overstaying visa
overstaying their visa	subtheme=overstaying visa
people who are overstaying their visa	subtheme=overstaying visa
free movement rules	subtheme=freedom of movement
freedom of movement rules	subtheme=freedom of movement
illegal immigration	head=illegal immigrants
immigrant	head=immigration
immigrants	head=immigration
migrant workers	head=immigration
population change
benefit tourism	head=benefit
benefit tourist	head=benefit
NHS tourism	head=NHS
NHS tourist	head=NHS
nhs tourism	head=NHS
nhs tourist	head=NHS
Dublin regulation
racism	head=racism
racist	modifier=pre
racial prejudice	head=racism
points based
borders
freedom of movement
right to remain
settled status
