national security
FCO	head=fco
FCO minister	head=fco
terrorism	head=terrorism
terrorist	head=terrorism
terrorists	head=terrorism
Al-Qaeda	head=al qaeda
bombing	head=bombing
bombings	head=bombing
Islamic State 
ISIL
Boko Haram
suicide bomber	head=suicide bombing
suicide bombers	head=suicide bombing
ISIS
counter-terrorism	head=terrorism
counter-terrorism strategy	head=terrorism
Ministry of Defence	head=Ministry of Defence
MOD	head=Ministry of Defence
terrorist attack	head=terrorism
terrorist attacks	head=terrorism
terrorist threat	head=terrorism
terrorist threats	head=terrorism
Al Qaeda	head=al qaeda
Counter-Terrorism Bill
Charlie Hebdo	head=charlie hebdo
I am Charlie	head=charlie hebdo
surveillance
political unrest	head=political unrest
political turmoil	head=political unrest
National Security Council
extremism
